Aigis	Aigis	aigis.tsv
Akihiko Sanada	Akihiko Sanada	akihiko.tsv
Chie Satonaka	Chie Satonaka	akihiko.tsv
Elizabeth	Elizabeth	akihiko.tsv
Junpei Iori	Junpei Iori	akihiko.tsv
Kanji Tatsumi	Kanji Tatsumi	akihiko.tsv
Ken Amada	Ken Amada	akihiko.tsv
Labrys	Labrys	akihiko.tsv
Margaret	Margaret	akihiko.tsv
Marie	Marie	akihiko.tsv
Minazuki	Minazuki	akihiko.tsv
Mitsuru Kirijo	Mitsuru Kirijo	akihiko.tsv
Naoto Shirogane	Naoto Shirogane	akihiko.tsv
Shadow Labrys	Shadow Labrys	akihiko.tsv
Sho	Sho	akihiko.tsv
Teddie	Teddie	akihiko.tsv
Tohru Adachi	Tohru Adachi	akihiko.tsv
Yosuke Hanamura	Yosuke Hanamura	akihiko.tsv
Yu Narukami	Yu Narukami	akihiko.tsv
Yukari Takeba	Yukari Takeba	akihiko.tsv
Yukiko Amagi	Yukiko Amagi	akihiko.tsv